0000000000000000000000000000000000000000000000000000000000
0000000000000000000000000000000000000000000000000000000000
0000000000000000000000000000000000000000000000000000000000
0000000000000000000000000000000000000000000000000000000000
0000000000000000000000000000000000000000000000000000000000
0000000000000000000000000000000000000000000000000000000000
0000000000000000000000000000000000000000000000000000000000
0000000000000000000000000000000000000000000000000000000000
0000000000000000000000000000000000000000000000000000000000
0000000000000000000000000000000000000000000000000000000000
0000000000000000000000000000000111111100000000000000000000
0000001111111111111111000001111111111111111111111111111111
1111111111111111111111110011111111111111111111111111111111
1111111111111111111111110001111111111111111111111111111111
1111111111111111111100000000111111111111111111111111111111
1111100000000000000000000100000011110001111110000001110011
1111100000000000000000111110000000000000000110000000000011
1111100000011100111111111111111000000100000010000000000011
1111111000011111111111111111111111111111110000000011111111
1111111100000111111111111111111111111111111000000001111111
1111111100000011111111111111111111111111111100000001111111
1111111111110000111111111111111111111111111111000001111111
1111111111110000001111111111111111111111111111000001111111
1111111111111110000111111111111000000100001111111111111111
1111111111111111000000000000000000000000000001111111000001
1111111111111111100000000000000011110001100000000000000001
1111111111111111111110111111111111111111111100000000011101
1111111111111111111110111111111111111111111111111000110001
1111111111100000000000000000000000011110000000000010000001
1111111111100000000000000000000000000000000000000010000011
1111111111100000110000000000000000000000000000000010000001
1111111111100000110000000000000000000000000000000010000001
1111111111111111111111111111111111111111111111111110001111
1111111111111111111111111111111111111111111111111110011111
1111111111111111111111111111111111111111111111000000000111
1111111111111111111111111111111111111111111100000000000111
1111111111111111111111111111111111111111000000000000000111
1111111111111111111111111111111111111100000000001111111111
1111111111111111111111111111111111110000000111111111111111
1111111111111111111111111111111000000000001111111111111111
1111111111111111111111111111110000000000011111111111111111
1111111111111111111111111111110000000000111111111111111111
1111111111111111111111111111110000000001111111111111111111
1111111111111111111111111111111000000011111111111111111111
1111111111111111111111111111111000000111111111111111111111
1111111111111111111111111111111000001111111111111111111111
1111111111111111111111111111111111111111111111111111111111
1111111111111111111111111111111111111111111111111111111111
1111111111111111111111111111111111111111111111111111111111
1111111111111111111111111111111111111111111111111111111111
1111111111111111111111111111111111111111111111111111111111